Sl. No.,Crime Head,Juveniles Apprehended - Boys,Juveniles Apprehended - Girls,Juveniles Apprehended - Transgender,Juveniles Apprehended - Total,18 Years & Above - Below 30 Years - Male ,18 Years & Above - Below 30 Years - Female,18 Years & Above - Below 30 Years - Transgender,18 Years & Above - Below 30 Years - Total,30 Years & above - Below 45 Years - Male,30 Years & above - Below 45 Years - Female,30 Years & above - Below 45 Years - Transgender,30 Years & above - Below 45 Years - Total,45 Years & above - Below 60 Years - Male ,45 Years & above - Below 60 Years - Female,45 Years & above - Below 60 Years - Transgender,45 Years & above - Below 60 Years - Total,60 Years & Above - Male,60 Years & Above - Female,60 Years & Above - Transgender,60 Years & Above - Total,Total of Overall Age Group - Male ,Total of Overall Age Group - Female,Total of Overall Age Group - Transgender,Total of Overall Age Group - Total
1,The Dowry Prohibition Act,0,0,0,0,298,80,0,378,745,267,0,1012,306,275,0,581,191,107,0,298,1540,729,0,2269
2,The Immoral Traffic (Prevention) Act,0,0,0,0,444,112,0,556,345,153,0,498,81,25,0,106,3,3,0,6,873,293,0,1166
3,The Protection of Women from Domestic Violence Act,0,0,0,0,4,0,0,4,3,0,0,3,3,0,0,3,1,0,0,1,11,0,0,11
4,The Indecent Representation of Women (Prohibition) Act,0,0,0,0,0,0,0,0,0,0,0,0,0,0,0,0,0,0,0,0,0,0,0,0
Crime Against Women – Related Acts,Crime Against Women – Related Acts,0,0,0,0,746,192,0,938,1093,420,0,1513,390,300,0,690,195,110,0,305,2424,1022,0,3446
5,The Protection of Children from Sexual Offences Act,375,0,0,375,3953,55,0,4008,2089,74,2,2165,571,25,0,596,29,1,0,30,7017,155,2,7174
6,The Juvenile Justice (Care and Protection of Children) Act,18,0,0,18,134,10,0,144,168,20,0,188,57,7,0,64,5,0,0,5,382,37,0,419
7,The Prohibition of Child Marriage Act,0,0,0,0,32,1,0,33,31,10,0,41,5,5,0,10,2,0,0,2,70,16,0,86
8,The Pre-Natal Diagnostic Techniques (Reg and Prev of Misuse) Act,0,0,0,0,7,0,0,7,3,0,0,3,0,0,0,0,0,0,0,0,10,0,0,10
9,The Child Labour (Prohibition & Regulation) Act,0,0,0,0,49,2,0,51,78,4,0,82,25,0,0,25,4,0,0,4,156,6,0,162
10,The Medical Termination of Pregnancy Act,0,0,0,0,0,0,0,0,0,0,0,0,0,0,0,0,0,0,0,0,0,0,0,0
Children Related – Acts,Children Related – Acts,393,0,0,393,4175,68,0,4243,2369,108,2,2479,658,37,0,695,40,1,0,41,7635,214,2,7851
11,The SC/ST (Prevention of Atrocities) Act against SCs,0,0,0,0,163,1,0,164,227,11,0,238,117,5,0,122,0,0,0,0,507,17,0,524
12,The SC/ST (Prevention of Atrocities) Act against STs,0,0,0,0,7,0,0,7,5,1,0,6,4,0,0,4,0,0,0,0,16,1,0,17
13,The Protection of Civil Rights Act against SCs,0,0,0,0,0,0,0,0,0,0,0,0,0,0,0,0,0,0,0,0,0,0,0,0
14,The Protection of Civil Rights Act against STs,0,0,0,0,0,0,0,0,0,0,0,0,0,0,0,0,0,0,0,0,0,0,0,0
Scheduled Castes and Scheduled Tribes – Related Acts,Scheduled Castes and Scheduled Tribes – Related Acts,0,0,0,0,170,1,0,171,232,12,0,244,121,5,0,126,0,0,0,0,523,18,0,541
15,The Prevention of Damage to Public Property Act,2,0,0,2,140,3,0,143,133,2,0,135,13,1,0,14,2,0,0,2,290,6,0,296
16,The Unlawful Activities (P) Act,0,0,0,0,7,0,0,7,14,1,0,15,1,0,0,1,0,0,0,0,22,1,0,23
17,The Official Secrets Act,0,0,0,0,5,1,0,6,5,0,0,5,0,0,0,0,0,0,0,0,10,1,0,11
Offences against State - Related Acts,Offences against State - Related Acts,2,0,0,2,152,4,0,156,152,3,0,155,14,1,0,15,2,0,0,2,322,8,0,330
18,The Arms Act,74,0,0,74,6692,2,0,6694,2808,15,0,2823,505,2,0,507,7,1,0,8,10086,20,0,10106
18.1,Fire Arms,34,0,0,34,2655,1,0,2656,1278,1,0,1279,215,0,0,215,4,0,0,4,4186,2,0,4188
18.1.1,Legal/Licensed Arms,1,0,0,1,15,0,0,15,7,0,0,7,4,0,0,4,0,0,0,0,27,0,0,27
18.1.2,Illegal/Unlicensed Arms,33,0,0,33,2640,1,0,2641,1271,1,0,1272,211,0,0,211,4,0,0,4,4159,2,0,4161
18.2,Other Arms,40,0,0,40,4037,1,0,4038,1530,14,0,1544,290,2,0,292,3,1,0,4,5900,18,0,5918
19,The Explosives Act,1,0,0,1,107,0,0,107,61,2,0,63,21,1,0,22,3,1,0,4,193,4,0,197
20,The Explosive Substances Act,1,0,0,1,83,1,0,84,106,2,0,108,28,1,0,29,1,0,0,1,219,4,0,223
Arms/Explosive - Related Acts,Arms/Explosive - Related Acts,76,0,0,76,6882,3,0,6885,2975,19,0,2994,554,4,0,558,11,2,0,13,10498,28,0,10526
21,The Information Technology Act,18,0,0,18,1136,30,0,1166,1148,17,0,1165,302,0,0,302,10,1,0,11,2614,48,0,2662
22,The Copy Right Act,1,0,0,1,388,0,0,388,435,2,0,437,123,1,0,124,1,0,0,1,948,3,0,951
23,The Trade Marks Act,0,0,0,0,53,0,0,53,39,0,0,39,4,0,0,4,0,0,0,0,96,0,0,96
Information Technology/Intellectual Property – Related Acts,Information Technology/Intellectual Property – Related Acts,19,0,0,19,1577,30,0,1607,1622,19,0,1641,429,1,0,430,11,1,0,12,3658,51,0,3709
24,The Lotteries (Regulation) Act,0,0,0,0,69,0,0,69,147,0,0,147,121,2,0,123,53,0,0,53,390,2,0,392
25,The Chit Funds Acts,0,0,0,0,3,1,0,4,11,3,0,14,4,5,0,9,1,0,0,1,19,9,0,28
26,The Negotiable Instruments Act,0,0,0,0,0,0,0,0,0,0,0,0,0,0,0,0,0,0,0,0,0,0,0,0
27,The Benami Transaction (Prohibition) Act,0,0,0,0,0,0,0,0,0,0,0,0,0,0,0,0,0,0,0,0,0,0,0,0
28,The Mines and Minerals (Development and Regulation) Act,0,0,0,0,8,0,0,8,15,0,0,15,6,0,0,6,0,0,0,0,29,0,0,29
29,Prevention of Corruption Act,0,0,0,0,29,0,0,29,62,3,0,65,14,1,0,15,1,0,0,1,106,4,0,110
Finance & Economic Acts,Finance & Economic Acts,0,0,0,0,109,1,0,110,235,6,0,241,145,8,0,153,55,0,0,55,544,15,0,559
30,Prohibition Act (State),22,0,0,22,20834,3377,0,24211,23150,6590,0,29740,8329,4352,0,12681,699,449,0,1148,53034,14768,0,67802
31,The Excise Act,54,0,0,54,4512,297,0,4809,3585,611,0,4196,1234,207,0,1441,47,12,0,59,9432,1127,0,10559
32,The Narcotic Drugs & Psychotropic Substances Act,44,0,0,44,14296,110,0,14406,5589,208,0,5797,1461,78,0,1539,74,9,0,83,21464,405,0,21869
32.1,Possession of drugs for Personal use/Consumption,11,0,0,11,11171,31,0,11202,3720,42,0,3762,990,16,0,1006,47,0,0,47,15939,89,0,16028
32.2,Possession of drugs for Trafficking,33,0,0,33,3125,79,0,3204,1869,166,0,2035,471,62,0,533,27,9,0,36,5525,316,0,5841
Liquor & Narcotic Drugs – Related Acts,Liquor & Narcotic Drugs – Related Acts,120,0,0,120,39642,3784,0,43426,32324,7409,0,39733,11024,4637,0,15661,820,470,0,1290,83930,16300,0,100230
33,The Forest Act & The Forest Conservation Act,2,0,0,2,37,0,0,37,34,0,0,34,4,0,0,4,0,0,0,0,77,0,0,77
34,The Wildlife Protection Act,0,0,0,0,32,0,0,32,56,0,0,56,20,0,0,20,1,0,0,1,109,0,0,109
35,The Environmental (Protection) Act,0,0,0,0,25,0,0,25,22,0,0,22,8,0,0,8,0,0,0,0,55,0,0,55
36,The Air & The Water (Prevention & Control of Pollution) Act,0,0,0,0,10,0,0,10,12,0,0,12,0,0,0,0,0,0,0,0,22,0,0,22
37,The Cigarette and Other Tobacco Products Act,6,0,0,6,2054,33,0,2087,2113,97,0,2210,1314,66,0,1380,273,32,0,305,5760,228,0,5988
38,Noise Pollution Acts,1,0,0,1,364,0,0,364,246,0,0,246,79,0,0,79,1,0,0,1,691,0,0,691
39,The National Green Tribunal Act,0,0,0,0,0,0,0,0,0,0,0,0,0,0,0,0,0,0,0,0,0,0,0,0
Environment & Pollution– Related Acts,Environment & Pollution– Related Acts,9,0,0,9,2522,33,0,2555,2483,97,0,2580,1425,66,0,1491,275,32,0,307,6714,228,0,6942
40,The Registration of Foreigners Act & The Foreigners Act,0,0,0,0,193,33,0,226,198,17,0,215,24,1,0,25,9,3,0,12,424,54,0,478
41,The Passport Act,0,0,0,0,71,5,0,76,120,12,0,132,34,2,0,36,4,0,0,4,229,19,0,248
42,The Emigration Act,0,0,0,0,6,0,0,6,0,0,0,0,0,0,0,0,0,0,0,0,6,0,0,6
43,The Citizenship Act,0,0,0,0,0,0,0,0,0,0,0,0,0,0,0,0,0,0,0,0,0,0,0,0
Foreigner & Passport – Related Acts,Foreigner & Passport – Related Acts,0,0,0,0,270,38,0,308,318,29,0,347,58,3,0,61,13,3,0,16,659,73,0,732
44,The Indian Railways Act,0,0,0,0,0,0,0,0,3,0,0,3,0,0,0,0,0,0,0,0,3,0,0,3
45,The Railway Property (Unlawful Possession) Act,0,0,0,0,0,0,0,0,0,0,0,0,0,0,0,0,0,0,0,0,0,0,0,0
Railways – Related Acts,Railways – Related Acts,0,0,0,0,0,0,0,0,3,0,0,3,0,0,0,0,0,0,0,0,3,0,0,3
46,The Indian Telegraph Act,0,0,0,0,4,0,0,4,3,0,0,3,1,0,0,1,0,0,0,0,8,0,0,8
47,The Telegraph Wire (Unlawful Possession) Act,0,0,0,0,0,0,0,0,0,0,0,0,0,0,0,0,0,0,0,0,0,0,0,0
48,The Cinematograph Act,0,0,0,0,0,0,0,0,1,0,0,1,0,0,0,0,0,0,0,0,1,0,0,1
49,The Cable Television Networks (Regulation) Act,0,0,0,0,0,0,0,0,0,0,0,0,0,0,0,0,0,0,0,0,0,0,0,0
Telegraph/Cinematograph Acts,Telegraph/Cinematograph Acts,0,0,0,0,4,0,0,4,4,0,0,4,1,0,0,1,0,0,0,0,9,0,0,9
50,The Essential Commodities Act,0,0,0,0,231,3,0,234,214,3,0,217,48,0,0,48,6,0,0,6,499,6,0,505
51,The Prevention of Food Adulteration Act,0,0,0,0,0,0,0,0,0,0,0,0,0,0,0,0,0,0,0,0,0,0,0,0
52,The Food Safety & Standards Act,0,0,0,0,3,0,0,3,6,0,0,6,0,0,0,0,0,0,0,0,9,0,0,9
"Food, Drugs and Essential Commodities Acts","Food, Drugs and Essential Commodities Acts",0,0,0,0,234,3,0,237,220,3,0,223,48,0,0,48,6,0,0,6,508,6,0,514
53,MACOCA/Control of Organised Crimes ,0,0,0,0,22,0,0,22,27,1,0,28,0,0,0,0,0,0,0,0,49,1,0,50
54,The Gambling Act,10,0,0,10,15279,98,0,15377,16271,211,0,16482,6626,103,0,6729,651,10,0,661,38837,422,0,39259
55,The Electricity Act,2,0,0,2,844,9,0,853,956,33,0,989,555,19,0,574,17,0,0,17,2374,61,0,2435
56,The Antiques and Art Treasures Act,0,0,0,0,3,0,0,3,2,0,0,2,0,0,0,0,0,0,0,0,5,0,0,5
57,The Representation of the People Act,0,0,0,0,7,0,0,7,9,1,0,10,5,2,0,7,1,0,0,1,22,3,0,25
58,The Bonded Labour System (Abolition) Act,0,0,0,0,5,0,0,5,4,0,0,4,6,0,0,6,1,0,0,1,16,0,0,16
58.1,Against SC,0,0,0,0,5,0,0,5,3,0,0,3,2,0,0,2,0,0,0,0,10,0,0,10
58.2,Against ST,0,0,0,0,0,0,0,0,0,0,0,0,0,0,0,0,0,0,0,0,0,0,0,0
58.3,Against others,0,0,0,0,0,0,0,0,1,0,0,1,4,0,0,4,1,0,0,1,6,0,0,6
59,The Prevention of Insults to National Honour Act,0,0,0,0,3,0,0,3,1,0,0,1,1,0,0,1,0,0,0,0,5,0,0,5
60,Defacement of Public Property Acts,0,0,0,0,558,15,0,573,285,9,0,294,38,2,0,40,1,0,0,1,882,26,0,908
61,The Transplantation of Human Organs Act,0,0,0,0,0,0,0,0,2,0,0,2,0,0,0,0,0,0,0,0,2,0,0,2
62,Transgender Persons (Protection of Rights) Act,0,0,0,0,0,0,0,0,2,0,0,2,0,0,0,0,0,0,0,0,2,0,0,2
63,The Mental Health Act,0,0,0,0,0,0,0,0,0,0,0,0,0,0,0,0,0,0,0,0,0,0,0,0
64,Motor Vehicle Act,1,0,0,1,1258,0,0,1258,1380,1,0,1381,437,0,0,437,21,0,0,21,3097,1,0,3098
65,City/Town Police Acts,1,0,0,1,12304,69,0,12373,6702,65,0,6767,5667,24,0,5691,1064,13,0,1077,25738,171,0,25909
66,Other State Local Acts,5,0,0,5,10563,76,0,10639,9791,128,0,9919,2653,59,0,2712,311,11,0,322,23323,274,0,23597
Other Regulatory & Enforcement – Acts,Other Regulatory & Enforcement – Acts,19,0,0,19,40846,267,0,41113,35432,449,0,35881,15988,209,0,16197,2067,34,0,2101,94352,959,0,95311
67,Other SLL Crimes,21,0,0,21,55976,241,0,56217,38759,359,0,39118,15046,142,0,15188,1242,18,0,1260,111044,760,0,111804
Total Cognizable SLL Crimes,Total Cognizable SLL Crimes,659,0,0,659,153305,4665,0,157970,118221,8933,2,127156,45901,5413,0,51314,4737,671,0,5408,322823,19682,2,342507
